HTML

br - quebra de linha
&lt; - menor que
&gt; maior que
&#xcodigo do emoji - mostra emoji
strong - negrito
em - italico
ins - texto inserido
del - texto excluído
mark - marcar texto
big - texto grande
small - texto pequeno
sup - texto sobrescrito
sub - texto subscrito
code - código fonte
pre - pre formatar texto
q - citação simples
blockquote - citação completa
abbr - abreviação
bdo - inverter texto
ol - listas ordenadas
ul - listas não ordenadas
li - escrever elementos da lista
dl - listas de definição
dt - termo de definição
dd - descrição da definição
a - ancora(links)
Para links externos utiliza-se duas tags: target = _blank e rel = external
download "nome do arquivo" - fazer download de um arquivo
Código para imagens que se adaptam ao tamanho da tela = picture, img e source media type
audio - colocar audio no site
header - para cabeçalho do site
nav - para navegação(links)
main - conteúdo principal do site
section - seção
article - artigo
aside - faz referencia ao conteudo principal
footer - rodape do site
estrutura de uma tabela:
Table - tag da tabela
  tr - linha da tabela
    th - cabeçalho da tabela
    td - dado da tabela
anatomia de uma tabela:
  Caption: título da tabela
  Thead: Cabeça da tabela
  Tbody: Corpo da tabela
  Tfoot: pé da tabela
scope: escopo de um th, utiliza-se scope col para o dado de um th que está na mesma coluna ou scope row para um dado de um th que está na mesma linha
mesclagem de celula: rowspan(deifine qnts linhas a celula vai ocupar), colspan(define quantas colunas a celula vai ocupar)
colgroup - é possivel dar nome para as colunas e estilizá-las
iframe - podemos utilizar conteúdos de outras páginas em um quadro dentro da página do nosso site
srcdoc - podemos escrever em html dentro de um iframe(o conteúdo só será exibido se o iframe estiver vazio)
sandbox - permissoes do iframe de coletar dados('sandbox' não coleta dado nenhum)
referrer-policy - politica de referencia
form - cria um formulario
  action - define para onde será enviado os dados do input
  autocomplete - define se ao passar o mouse por cima do formulario, ele completa com os dados ou nao
  method - (get = mostra os dados digitados explicitos na url), (post = não mostra os dados na url)
input - cria a caixinha de interaçao de dados
  obs: ao utiliza input do tupo envio de arquivo deve-se utilizar o metodo post
  required(obriga o usuario a digitar alguma coisa no formulario)
  placeholder - dica dentro do formulário
  minleght(minimo de letras)
  maxlenght(maximo de letras)
  min - numero minimo permitido
  max - numero maximo permitido
  value - valor que já aparece por padrao no formulario
  step - qual o valor do passo do número
  size(tamanho da caixa do formulario)
  autocomplete(cria um vinculo com oq vai ser digitado no formulario)
  cheked - ja deixa marcada um checkbox ou um radio
input radio - deve-se usar o msm name em todos os radios semanticamente iguais, e definir um value com o msm nome do radio.
label - cria um vinculo do nome com o input(identifica-se com seu id)
pattern - cria uma expressao regular
fieldset - cria um agrupamento
  legend - cria um titulo no agrupamento
select - cria uma lista de seleção
  option - cria opções da lista de seleção
  optgroup - cria um grupo de opções(label dá o nome ao grupo)
datalist - pode fazer uma junção de um input normal com uma lista(para utiliza-lo você precisa definir seu id, e dentro do input criar o parametro list, com o id do datalist dentro.)
textarea - cria uma area para digitar um texto sem limites.
output - permite a saida de valores, dados(necessita aprender programação(javascript))
media queries - cria um estilo para uma determinada midia(telas diferente, dispositivos diferentes(impressoras, etc))
  obs: utiliza-se o link css
  media type - tipo de media = tela, impressora, dispositivo de mão, etc.
  media future - caracteristica da media = adicionada logo dps da media type, com um and e entre parenteses.




Modelos de caixas

Caixas possuem uma borda(border), padding(acochoamento), margin(margem), outline(contorno)
Box-level(div, h1-h6, p, main, header, nav, article, aside, footer, form, video)
Inline-level(span, a, code, small, strong, em, sup-sub, label, button, input, select))

CSS

@ - regra
*{} - configuração geral das CSS
background - shorthand do background(1- cor, 2- image, 3- position, 4- repeat, 5- attachment)
background-image: linear-gradient - degradê
background-image: url(colocar imagem de fundo)
background-size: tamanho da imagem(contain(a imagem ocupa todo o fundo do site, porem reduz muito o tamanho da imagem), cover(a imagem ocupa todo o fundo do site, porem corta a imagem dependendo do tamanho da resolução))
background-attachment: fixa o fundo na tela
para alinhar verticalmente uma caixa dentro da outra(utiliza-se o position relative para o container e position absolute para o conteudo, utilizando o top 50% e left 50%, logo depois usa-se o transform: translate(-50%, -50%))
font - shorthand de fonte(1- font style 2- font-weight 3- font-size 4- font-family)
@font-face - importar fonte baixada
format(.otf = opentype, .ttf = truetype)
id = # em CSS (só pode um elemento)
class = . em CSS (pode varios elementos)
> - filhos
: - pseudoclasses
:: - pseudoelementos
width - largura
height- altura
  obs: vh(tamanho de acordo com a view port(tela))
border - shorthand de borda(1- largura, 2- estilo, 3- cor)
border-collapse - separar ou juntar bordas
margin - shorthand de margem(tamanho[cima, direita, baixo, esquerda]) 
  obs: 1 tamanho = todos tamanhos iguais, 2 tamanhos = cima e baixo iguais, e direita e esquerda iguais
padding - shorthand de padding(tamanho[cima, direita, baixo, esquerda])
  obs: 1 tamanho = todos tamanhos iguais, 2 tamanhos = cima e baixo iguais, e direita e esquerda iguais
outline - shorthand de contorno(1- largura, 2- estilo, 3-cor)
box-shadow - cria uma sombra ao redor do conteudo(1- espaçamento horizontal, 2- espaçamento vertical, 3- cor)
border-radius - borda arredondada(1 só valor = todos lados iguais, 2 valores = pontas opostas iguais)
border-image - shorthand de border-image(1- url, 2- slice, 3- repeat)
:root - area pra declarar variaveis
  obs: toda variavel deve ter -- antes.
position - posição de um elemento(fixo, relativo, pegajoso...)
list-style-position - posição do marcador da lista
list-style - estilo do marcador da lista(\código do emoji)
colums- numero de colunas que a lista terá
overflow - utilizado pra deixar as tabelas responsivas
media queries - utiliza-se o @media
calc - faz um calculo dentro da css



